WWWWWWWWWWWWWWWWWWWWWWWWWWWWWWWWWWWW
WWWWWWWWWWWWWWWWWWWWWWWWWWWWWWWWWWWW
WWWWWWWWWWWWWWWWWWWWWWWWWWWWWWWWWWWW
WWWWWWWWWWWWWWWWWWWWWWWWWWWWWWWWWWWW
WWWWWWWWWWWWWWWWWWWWWWWWWWWWWWWWWWWW
WWWWWWWWWWWWWWWWWWWWWWWWWWWWWWWWWWWW
WWWWWWWWWWWWWWWWWWWWWWWWWWWWWWWWWWWW
BBBBBBBBBBBBBBBBBBWWWWBBBBBBBBBBBBBB
GGGGGGGGGGGGGGGGGBWWWWBGGGGGGGGGGGGG
GGGGGGGGGGGGGGGGGBWWWWBGGGGGGGGGGGGG
GGGGGGGGGGGGGGGGGBWWWWBGGGGGGGGGGGGG
GGGGGGGGGGGGGGGGGBWWWWBGGGGGGGGGGGGG
GGGGGGGGGGGGGGGGGBWWWWBGGGGGGGGGGGGG
GGGGGGGGGGGGGGGGGBWWWWBGGGGGGGGGGGGG
GGGGGGGGGGGGGGGGGBWWWWBGGGGGGGGGGGGG
GGGGGGGGGGGGGGGGGBBBBBBGGGGGGGGGGGGG
GGGGGGGGGGGGGGGGGBBBBBBGGGGGGGGGGGGG
GGGGGGGGGGGGGGGGGBWWWWBGGGGGGGGGGGGG
GGGGGGGGGGGGGGGGGBWWWWBGGGGGGGGGGGGG
GGGGGGGGGGGGGGGGGBWWWWBGGGGGGGGGGGGG
GGGGGGGGGGGGGGGGGBWWWWBGGGGGGGGGGGGG
GGGGGGGGGGGGGGGGGBWWWWBGGGGGGGGGGGGG
GGGGGGGGGGGGGGGGGBWWWWBGGGGGGGGGGGGG
GGGGGGGGGGGGGGGGGBWWWWBGGGGGGGGGGGGG
GGGGGGGGGGGGGGGGGBBBBBBGGGGGGGGGGGGG
GGGGGGGGGGGGGGGGGBBBBBBGGGGGGGGGGGGG
GGGGGGGGGGGGGGGGGBWWWWBGGGGGGGGGGGGG
GGGGGGGGGGGGGGGGGBWWWWBGGGGGGGGGGGGG
GGGGGGGGGGGGGGGGGBWWWWBGGGGGGGGGGGGG
GGGGGGGGGGGGGGGGGBWWWWBGGGGGGGGGGGGG
GGGGGGGGGGGGGGGGGBWWWWBGGGGGGGGGGGGG
GGGGGGGGGGGGGGGGGBWWWWBGGGGGGGGGGGGG
GGGGGGGGGGGGGGGGGBWWWWBGGGGGGGGGGGGG
GGGGGGGGGGGGGGGGGBWWWWBGGGGGGGGGGGGG